StageCount
7

index	X		Y		Width		Height		CameraBeginX	CameraBeginY	RockmanBeginX	RockmanBeginY
0		2816	3600	768			240 		2816 			3619 			2830			3700
1		3584	3600	256			240			3584			3619			3600			3660
2		2304	3600	512			240			2304			3619			2370			3610
3		2304	3360	256			240			2304			3369			2440			3399
4		2304	3120	256			240			2304			3129			2405			3190
5		2304	2880	256			240			2304 			2888 			2470 			2910
6		0		2640	2560		240			0 				2651  			90		 		2580		

StageBegin
6