StageCount
7

index	X		Y		Width		Height	
0		2816	3600	768			240		3450			3600		3500			3700
1		3584	3600	256			240		3450			3600		3500			3700
2		2304	3600	512			240		3450			3600		3500			3700
3		2304	3360	256			240		3450			3600		3500			3700
4		2304	3120	256			240		3450			3600		3500			3700
5		2304	2880	256			240		3450			3600		3500			3700
6		0		2640	2560		240		3450			3600		3500			3700

CameraBeginX	CameraBeginY
3450			3600

RockmanBeginX	RockmanBeginY
3500			3700

StageBegin
0