StageCount
11

index	X		Y		Width		Height		CameraBeginX	CameraBeginY	RockmanBeginX	RockmanBeginY
0		0		3119	1024		225			0				3120			100				3060
1		768		2887	256			225 		768				2887			836				3053
2		768		2647	256			225			768				2647			788				2667
3		768		2407	256			225			768				2407 			788				2427
4		768		2167	768			225			768				2167			833				2324
5		1280	1927	1024		225			1280			1927			1450			2070
6		1280	1687	768			225 		1792			1687			1870			1846
7		1280	1447	768			225			1280			1447			1312			1616
8		1280	1216	768			225			1280			1216			1331			1335
9		2304	1927	784			225			2304			1927			2340			2030
10		3088	1927	256			225			3088			1927			3100			1950

StageBegin
8
